"filename", "language", "C++", "Markdown", "comment", "blank", "total"
"f:\GITHUB\CppLeetNinjas\0001两数之和\two-sum.cpp", "C++", 19, 0, 1, 2, 22
"f:\GITHUB\CppLeetNinjas\0002两数相加\0002两数相加.cpp", "C++", 40, 0, 0, 6, 46
"f:\GITHUB\CppLeetNinjas\0002两数相加\0002两数相加优化.cpp", "C++", 28, 0, 0, 6, 34
"f:\GITHUB\CppLeetNinjas\0003无重复字符的最长子串\0003无重复字符的最长子串.cpp", "C++", 17, 0, 3, 3, 23
"f:\GITHUB\CppLeetNinjas\0005最长回文子串\0005最长回文子串.cpp", "C++", 27, 0, 0, 1, 28
"f:\GITHUB\CppLeetNinjas\0006N字形变换\0006N字形变换.cpp", "C++", 26, 0, 0, 5, 31
"f:\GITHUB\CppLeetNinjas\0007整数反转\7整数反转.cpp", "C++", 15, 0, 0, 5, 20
"f:\GITHUB\CppLeetNinjas\0008字符串转整数\0008字符串转整数.cpp", "C++", 32, 0, 4, 7, 43
"f:\GITHUB\CppLeetNinjas\0009回文数\0009回文数.cpp", "C++", 14, 0, 0, 2, 16
"f:\GITHUB\CppLeetNinjas\0011盛最多水的容器\0011盛最多水的容器.cpp", "C++", 16, 0, 0, 4, 20
"f:\GITHUB\CppLeetNinjas\0015三数之和\3sum_hashmap.cpp", "C++", 41, 0, 7, 4, 52
"f:\GITHUB\CppLeetNinjas\0015三数之和\3sum_two_pointer.cpp", "C++", 34, 0, 5, 11, 50
"f:\GITHUB\CppLeetNinjas\0015三数之和\README.markdown", "Markdown", 0, 128, 0, 58, 186
"f:\GITHUB\CppLeetNinjas\0017电话号码的字母组合\17.电话号码的字母组合.cpp", "C++", 31, 0, 7, 4, 42
"f:\GITHUB\CppLeetNinjas\0018四数之和\4sum.cpp", "C++", 39, 0, 0, 10, 49
"f:\GITHUB\CppLeetNinjas\0018四数之和\README.markdown", "Markdown", 0, 24, 0, 10, 34
"f:\GITHUB\CppLeetNinjas\0019删除链表的倒数第 N 个结点\0019remove-nth-node-from-end-of-list.cpp", "C++", 27, 0, 0, 2, 29
"f:\GITHUB\CppLeetNinjas\0020有效的括号\20.有效的括号.cpp", "C++", 31, 0, 7, 6, 44
"f:\GITHUB\CppLeetNinjas\0024两两交换链表中的节点\0024swap-nodes-in-pairs_dd.cpp", "C++", 34, 0, 1, 2, 37
"f:\GITHUB\CppLeetNinjas\0024两两交换链表中的节点\0024swap-nodes-in-pairs_dg.cpp", "C++", 31, 0, 4, 2, 37
"f:\GITHUB\CppLeetNinjas\0027移除元素\remove_element.cpp", "C++", 21, 0, 0, 2, 23
"f:\GITHUB\CppLeetNinjas\0028找出字符串中第一个匹配项的下标\find-the-index-of-the-first-occurrence-in-a-string.cpp", "C++", 32, 0, 2, 5, 39
"f:\GITHUB\CppLeetNinjas\0039组合总和\39.组合总和.cpp", "C++", 28, 0, 7, 4, 39
"f:\GITHUB\CppLeetNinjas\0040组合总和II\40.组合总和-ii.cpp", "C++", 31, 0, 7, 5, 43
"f:\GITHUB\CppLeetNinjas\0046全排列\46.全排列.cpp", "C++", 28, 0, 7, 3, 38
"f:\GITHUB\CppLeetNinjas\0047全排列II\47.全排列-ii 优化.cpp", "C++", 30, 0, 7, 5, 42
"f:\GITHUB\CppLeetNinjas\0047全排列II\47.全排列-ii.cpp", "C++", 30, 0, 7, 4, 41
"f:\GITHUB\CppLeetNinjas\0059螺旋矩阵 II\spiral-matrix-ii.cpp", "C++", 39, 0, 4, 5, 48
"f:\GITHUB\CppLeetNinjas\0071简化路径\0071简化路径.cpp", "C++", 29, 0, 0, 3, 32
"f:\GITHUB\CppLeetNinjas\0072编辑距离\72编辑距离.cpp", "C++", 23, 0, 0, 3, 26
"f:\GITHUB\CppLeetNinjas\0073矩阵置零\73矩阵置零.cpp", "C++", 26, 0, 0, 4, 30
"f:\GITHUB\CppLeetNinjas\0073矩阵置零\73矩阵置零空间优化.cpp", "C++", 26, 0, 0, 4, 30
"f:\GITHUB\CppLeetNinjas\0074搜索二维矩阵\74搜索二维矩阵.cpp", "C++", 34, 0, 0, 4, 38
"f:\GITHUB\CppLeetNinjas\0074搜索二维矩阵\74搜索二维矩阵11.cpp", "C++", 36, 0, 0, 5, 41
"f:\GITHUB\CppLeetNinjas\0075颜色分类\75颜色分类.cpp", "C++", 24, 0, 0, 1, 25
"f:\GITHUB\CppLeetNinjas\0077组合\77.组合.cpp", "C++", 23, 0, 7, 3, 33
"f:\GITHUB\CppLeetNinjas\0078子集\78.子集.cpp", "C++", 20, 0, 7, 3, 30
"f:\GITHUB\CppLeetNinjas\0079单词搜索\79单词搜索.cpp", "C++", 43, 0, 6, 10, 59
"f:\GITHUB\CppLeetNinjas\0079单词搜索\79单词搜索优化.cpp", "C++", 39, 0, 1, 7, 47
"f:\GITHUB\CppLeetNinjas\0080删除有序数组中的重复项 II\80.删除有序数组中的重复项II.cpp", "C++", 16, 0, 5, 4, 25
"f:\GITHUB\CppLeetNinjas\0081搜索旋转排序数组 II\搜索旋转排序数组 II.cpp", "C++", 31, 0, 0, 4, 35
"f:\GITHUB\CppLeetNinjas\0082删除排序链表中的重复元素 II\82删除排序链表中的重复元素 II.cpp", "C++", 26, 0, 3, 4, 33
"f:\GITHUB\CppLeetNinjas\0082删除排序链表中的重复元素 II\82删除排序链表中的重复元素 II清理内存.cpp", "C++", 33, 0, 3, 2, 38
"f:\GITHUB\CppLeetNinjas\0083删除排序链表中的重复元素\83.删除排序链表中的重复元素.cpp", "C++", 24, 0, 0, 3, 27
"f:\GITHUB\CppLeetNinjas\0086分隔链表\0086分隔链表.cpp", "C++", 29, 0, 0, 6, 35
"f:\GITHUB\CppLeetNinjas\0088合并两个有序数组\88合并两个有序数组.cpp", "C++", 14, 0, 0, 1, 15
"f:\GITHUB\CppLeetNinjas\0090子集II\90.子集-ii.cpp", "C++", 22, 0, 7, 5, 34
"f:\GITHUB\CppLeetNinjas\0091解码方法\91解码方法.cpp", "C++", 21, 0, 0, 3, 24
"f:\GITHUB\CppLeetNinjas\0092反转链表 II\92.反转链表 II.cpp", "C++", 28, 0, 1, 6, 35
"f:\GITHUB\CppLeetNinjas\0093复原IP地址\93.复原-ip-地址.cpp", "C++", 44, 0, 7, 8, 59
"f:\GITHUB\CppLeetNinjas\0094二叉树的中序遍历\94.二叉树的中序遍历迭代.cpp", "C++", 29, 0, 7, 8, 44
"f:\GITHUB\CppLeetNinjas\0094二叉树的中序遍历\94.二叉树的中序遍历递归.cpp", "C++", 27, 0, 7, 4, 38
"f:\GITHUB\CppLeetNinjas\0097交错字符串\97交错字符串.cpp", "C++", 26, 0, 0, 8, 34
"f:\GITHUB\CppLeetNinjas\0097交错字符串\97交错字符串优化.cpp", "C++", 25, 0, 0, 6, 31
"f:\GITHUB\CppLeetNinjas\0098验证二叉搜索树\98.验证二叉搜索树迭代实现.cpp", "C++", 31, 0, 8, 12, 51
"f:\GITHUB\CppLeetNinjas\0098验证二叉搜索树\98.验证二叉搜索树递归实现.cpp", "C++", 20, 0, 22, 7, 49
"f:\GITHUB\CppLeetNinjas\0099恢复二叉搜索树\0099恢复二叉搜索树.cpp", "C++", 30, 0, 0, 5, 35
"f:\GITHUB\CppLeetNinjas\0099恢复二叉搜索树\0099恢复二叉搜索树迭代.cpp", "C++", 34, 0, 0, 6, 40
"f:\GITHUB\CppLeetNinjas\0100相同的树\100相同的树.cpp", "C++", 19, 0, 0, 2, 21
"f:\GITHUB\CppLeetNinjas\0101对称二叉树\101.对称二叉树迭代实现.cpp", "C++", 40, 0, 9, 8, 57
"f:\GITHUB\CppLeetNinjas\0101对称二叉树\101.对称二叉树递归实现.cpp", "C++", 31, 0, 8, 4, 43
"f:\GITHUB\CppLeetNinjas\0101对称二叉树\README.markdown", "Markdown", 0, 30, 0, 7, 37
"f:\GITHUB\CppLeetNinjas\0102二叉树的层序遍历\102.二叉树的层序遍历.cpp", "C++", 33, 0, 8, 4, 45
"f:\GITHUB\CppLeetNinjas\0103二叉树的锯齿形层序遍历\103二叉树的锯齿形层序遍历.cpp", "C++", 44, 0, 1, 4, 49
"f:\GITHUB\CppLeetNinjas\0104二叉树的最大深度\104.二叉树的最大深度.cpp", "C++", 17, 0, 8, 3, 28
"f:\GITHUB\CppLeetNinjas\0105从前序与中序遍历序列构造二叉树\105.从前序与中序遍历序列构造二叉树.cpp", "C++", 39, 0, 8, 8, 55
"f:\GITHUB\CppLeetNinjas\0106从中序与后序遍历序列构造二叉树\106.从中序与后序遍历序列构造二叉树.cpp", "C++", 32, 0, 8, 3, 43
"f:\GITHUB\CppLeetNinjas\0106从中序与后序遍历序列构造二叉树\106.从中序与后序遍历序列构造二叉树优化.cpp", "C++", 40, 0, 8, 10, 58
"f:\GITHUB\CppLeetNinjas\0107二叉树的层序遍历II\107.二叉树的层序遍历-ii.cpp", "C++", 35, 0, 8, 5, 48
"f:\GITHUB\CppLeetNinjas\0108将有序数组转换为二叉搜索树\108.将有序数组转换为二叉搜索树.cpp", "C++", 27, 0, 8, 6, 41
"f:\GITHUB\CppLeetNinjas\0109有序链表转换二叉搜索树\109. 有序链表转换二叉搜索树.cpp", "C++", 36, 0, 1, 3, 40
"f:\GITHUB\CppLeetNinjas\0109有序链表转换二叉搜索树\109. 有序链表转换二叉搜索树直接使用链表.cpp", "C++", 35, 0, 2, 6, 43
"f:\GITHUB\CppLeetNinjas\0110平衡二叉树\110.平衡二叉树迭代法.cpp", "C++", 52, 0, 8, 6, 66
"f:\GITHUB\CppLeetNinjas\0110平衡二叉树\110.平衡二叉树递归法.cpp", "C++", 23, 0, 8, 8, 39
"f:\GITHUB\CppLeetNinjas\0110平衡二叉树\README.markdown", "Markdown", 0, 52, 0, 31, 83
"f:\GITHUB\CppLeetNinjas\0111二叉树的最小深度\111.二叉树的最小深度迭代法.cpp", "C++", 38, 0, 8, 3, 49
"f:\GITHUB\CppLeetNinjas\0111二叉树的最小深度\111.二叉树的最小深度递归法.cpp", "C++", 24, 0, 9, 6, 39
"f:\GITHUB\CppLeetNinjas\0112路径总和\112.路径总和.cpp", "C++", 20, 0, 8, 5, 33
"f:\GITHUB\CppLeetNinjas\0113路径总和II\113路径总和II.cpp", "C++", 34, 0, 1, 4, 39
"f:\GITHUB\CppLeetNinjas\0116填充每个节点的下一个右侧节点指针\116.填充每个节点的下一个右侧节点指针.cpp", "C++", 35, 0, 8, 7, 50
"f:\GITHUB\CppLeetNinjas\0117填充每个节点的下一个右侧节点指针II\117.填充每个节点的下一个右侧节点指针-ii.cpp", "C++", 35, 0, 8, 6, 49
"f:\GITHUB\CppLeetNinjas\0125验证回文串\0125验证回文串.cpp", "C++", 22, 0, 3, 6, 31
"f:\GITHUB\CppLeetNinjas\0131分割回文串\131.分割回文串.cpp", "C++", 35, 0, 7, 5, 47
"f:\GITHUB\CppLeetNinjas\0131分割回文串\131.分割回文串优化.cpp", "C++", 42, 0, 8, 5, 55
"f:\GITHUB\CppLeetNinjas\0142环形链表 II\142.环形链表-ii.cpp", "C++", 26, 0, 7, 4, 37
"f:\GITHUB\CppLeetNinjas\0144二叉树的前序遍历\144.二叉树的前序遍历迭代实现.cpp", "C++", 29, 0, 7, 5, 41
"f:\GITHUB\CppLeetNinjas\0144二叉树的前序遍历\144.二叉树的前序遍历递归实现.cpp", "C++", 26, 0, 7, 4, 37
"f:\GITHUB\CppLeetNinjas\0145二叉树的后序遍历\145.二叉树的后序遍历迭代01.cpp", "C++", 32, 0, 7, 4, 43
"f:\GITHUB\CppLeetNinjas\0145二叉树的后序遍历\145.二叉树的后序遍历迭代02.cpp", "C++", 44, 0, 7, 6, 57
"f:\GITHUB\CppLeetNinjas\0145二叉树的后序遍历\145.二叉树的后序遍历迭代03.cpp", "C++", 41, 0, 10, 8, 59
"f:\GITHUB\CppLeetNinjas\0145二叉树的后序遍历\145.二叉树的后序遍历递归.cpp", "C++", 26, 0, 19, 4, 49
"f:\GITHUB\CppLeetNinjas\0148排序链表\148排序链表.cpp", "C++", 42, 0, 1, 9, 52
"f:\GITHUB\CppLeetNinjas\0150逆波兰表达式求值\150.逆波兰表达式求值.cpp", "C++", 35, 0, 7, 4, 46
"f:\GITHUB\CppLeetNinjas\0151反转字符串中的单词\everse-words-in-a-string.cpp", "C++", 43, 0, 7, 13, 63
"f:\GITHUB\CppLeetNinjas\0156上下翻转二叉树\156.上下翻转二叉树.cpp", "C++", 23, 0, 1, 3, 27
"f:\GITHUB\CppLeetNinjas\0156上下翻转二叉树\README.md", "Markdown", 0, 46, 0, 26, 72
"f:\GITHUB\CppLeetNinjas\0159至多包含两个不同字符的最长子串\159.至多包含两个不同字符的最长子串.cpp", "C++", 24, 0, 0, 6, 30
"f:\GITHUB\CppLeetNinjas\0159至多包含两个不同字符的最长子串\159.至多包含两个不同字符的最长子串优化.cpp", "C++", 25, 0, 0, 5, 30
"f:\GITHUB\CppLeetNinjas\0159至多包含两个不同字符的最长子串\159.至多包含两个不同字符的最长子串（不用map）.cpp", "C++", 28, 0, 7, 10, 45
"f:\GITHUB\CppLeetNinjas\0162寻找峰值\162.寻找峰值.cpp", "C++", 17, 0, 0, 1, 18
"f:\GITHUB\CppLeetNinjas\0162寻找峰值\README.markdown", "Markdown", 0, 18, 0, 6, 24
"f:\GITHUB\CppLeetNinjas\0163缺失的区间\163.缺失的区间.cpp", "C++", 24, 0, 0, 5, 29
"f:\GITHUB\CppLeetNinjas\0163缺失的区间\163.缺失的区间优化.cpp", "C++", 17, 0, 0, 1, 18
"f:\GITHUB\CppLeetNinjas\0199二叉树的右视图\199.二叉树的右视图.cpp", "C++", 32, 0, 8, 4, 44
"f:\GITHUB\CppLeetNinjas\0202快乐数\0202happy-number.cpp", "C++", 30, 0, 5, 7, 42
"f:\GITHUB\CppLeetNinjas\0203移除链表元素\remove-linked-list-elements.cpp", "C++", 29, 0, 1, 3, 33
"f:\GITHUB\CppLeetNinjas\0203移除链表元素\remove-linked-list-elements_s.cpp", "C++", 29, 0, 1, 1, 31
"f:\GITHUB\CppLeetNinjas\0206反转链表\reverse-linked-list_dd.cpp", "C++", 21, 0, 1, 1, 23
"f:\GITHUB\CppLeetNinjas\0206反转链表\reverse-linked-list_dg.cpp", "C++", 19, 0, 1, 2, 22
"f:\GITHUB\CppLeetNinjas\0207课程表\207.课程表.cpp", "C++", 37, 0, 0, 8, 45
"f:\GITHUB\CppLeetNinjas\0209长度最小的子数组\minimum_size_subarray_sum.cpp", "C++", 26, 0, 0, 2, 28
"f:\GITHUB\CppLeetNinjas\0216组合\216.组合总和-iii.cpp", "C++", 25, 0, 11, 4, 40
"f:\GITHUB\CppLeetNinjas\0222完全二叉树的节点个数\222.完全二叉树的节点个数.cpp", "C++", 31, 0, 8, 9, 48
"f:\GITHUB\CppLeetNinjas\0225用队列实现栈\225.用队列实现栈.cpp", "C++", 23, 0, 15, 9, 47
"f:\GITHUB\CppLeetNinjas\0226翻转二叉树\226.翻转二叉树迭代解法.cpp", "C++", 30, 0, 8, 4, 42
"f:\GITHUB\CppLeetNinjas\0226翻转二叉树\226.翻转二叉树递归解法.cpp", "C++", 21, 0, 8, 4, 33
"f:\GITHUB\CppLeetNinjas\0232用栈实现队列\232.用栈实现队列.cpp", "C++", 44, 0, 15, 9, 68
"f:\GITHUB\CppLeetNinjas\0236二叉树的最近公共祖先\236.二叉树的最近公共祖先哈希.cpp", "C++", 38, 0, 8, 11, 57
"f:\GITHUB\CppLeetNinjas\0236二叉树的最近公共祖先\236.二叉树的最近公共祖先递归.cpp", "C++", 20, 0, 15, 8, 43
"f:\GITHUB\CppLeetNinjas\0236二叉树的最近公共祖先\README.markdown", "Markdown", 0, 29, 0, 15, 44
"f:\GITHUB\CppLeetNinjas\0239滑动窗口最大值\239.滑动窗口最大值_01.cpp", "C++", 36, 0, 7, 7, 50
"f:\GITHUB\CppLeetNinjas\0239滑动窗口最大值\239.滑动窗口最大值_02.cpp", "C++", 22, 0, 10, 7, 39
"f:\GITHUB\CppLeetNinjas\0242有效的字母异位词\README.markdown", "Markdown", 0, 85, 0, 9, 94
"f:\GITHUB\CppLeetNinjas\0242有效的字母异位词\valid-anagram.cpp", "C++", 21, 0, 3, 2, 26
"f:\GITHUB\CppLeetNinjas\0242有效的字母异位词\valid-anagram_v.cpp", "C++", 20, 0, 3, 3, 26
"f:\GITHUB\CppLeetNinjas\0243最短单词距离\243.最短单词距离.cpp", "C++", 20, 0, 1, 2, 23
"f:\GITHUB\CppLeetNinjas\0243最短单词距离\README.markdown", "Markdown", 0, 15, 0, 7, 22
"f:\GITHUB\CppLeetNinjas\0246中心对称的数\246.中心对称的数.cpp", "C++", 30, 0, 0, 2, 32
"f:\GITHUB\CppLeetNinjas\0246中心对称的数\246.中心对称的数优化.cpp", "C++", 21, 0, 2, 4, 27
"f:\GITHUB\CppLeetNinjas\0252会议室\252.会议室.cpp", "C++", 20, 0, 0, 4, 24
"f:\GITHUB\CppLeetNinjas\0257二叉树的所有路径\257.二叉树的所有路径双栈.cpp", "C++", 42, 0, 8, 6, 56
"f:\GITHUB\CppLeetNinjas\0257二叉树的所有路径\257.二叉树的所有路径哈希表.cpp", "C++", 43, 0, 8, 4, 55
"f:\GITHUB\CppLeetNinjas\0257二叉树的所有路径\257.二叉树的所有路径递归01.cpp", "C++", 39, 0, 8, 7, 54
"f:\GITHUB\CppLeetNinjas\0257二叉树的所有路径\257.二叉树的所有路径递归02.cpp", "C++", 38, 0, 8, 7, 53
"f:\GITHUB\CppLeetNinjas\0263丑数\0263.丑数.cpp", "C++", 12, 0, 4, 5, 21
"f:\GITHUB\CppLeetNinjas\0263丑数\README.md", "Markdown", 0, 4, 0, 3, 7
"f:\GITHUB\CppLeetNinjas\0264丑数 II\0264.丑数II.cpp", "C++", 18, 0, 0, 4, 22
"f:\GITHUB\CppLeetNinjas\0264丑数 II\README.md", "Markdown", 0, 15, 0, 6, 21
"f:\GITHUB\CppLeetNinjas\0266回文排列\266回文排列.cpp", "C++", 14, 0, 2, 3, 19
"f:\GITHUB\CppLeetNinjas\0268丢失的数字\268.丢失的数字.cpp", "C++", 14, 0, 0, 1, 15
"f:\GITHUB\CppLeetNinjas\0270最接近的二叉搜索树值\270. 最接近的二叉搜索树值.cpp", "C++", 36, 0, 2, 6, 44
"f:\GITHUB\CppLeetNinjas\0278第一个错误的版本\0278第一个错误的版本.cpp", "C++", 16, 0, 0, 0, 16
"f:\GITHUB\CppLeetNinjas\0307最大单词长度乘积\307.最大单词长度乘积.cpp", "C++", 29, 0, 1, 2, 32
"f:\GITHUB\CppLeetNinjas\0307最大单词长度乘积\307.最大单词长度乘积优化.cpp", "C++", 27, 0, 2, 4, 33
"f:\GITHUB\CppLeetNinjas\0307最大单词长度乘积\README.markdown", "Markdown", 0, 19, 0, 6, 25
"f:\GITHUB\CppLeetNinjas\0332重新安排行程\332.重新安排行程.cpp", "C++", 46, 0, 0, 3, 49
"f:\GITHUB\CppLeetNinjas\0344反转字符串\reverse-string.cpp", "C++", 16, 0, 1, 2, 19
"f:\GITHUB\CppLeetNinjas\0349两个数组的交集\README.markdown", "Markdown", 0, 22, 0, 16, 38
"f:\GITHUB\CppLeetNinjas\0349两个数组的交集\intersection-of-two-arrays_01.cpp", "C++", 16, 0, 4, 2, 22
"f:\GITHUB\CppLeetNinjas\0349两个数组的交集\intersection-of-two-arrays_02.cpp", "C++", 26, 0, 0, 4, 30
"f:\GITHUB\CppLeetNinjas\0383赎金信\ransom-note_01.cpp", "C++", 20, 0, 0, 3, 23
"f:\GITHUB\CppLeetNinjas\0383赎金信\ransom-note_02.cpp", "C++", 17, 0, 0, 2, 19
"f:\GITHUB\CppLeetNinjas\0404左叶子之和\404.左叶子之和迭代1.cpp", "C++", 37, 0, 8, 6, 51
"f:\GITHUB\CppLeetNinjas\0404左叶子之和\404.左叶子之和迭代2.cpp", "C++", 39, 0, 8, 5, 52
"f:\GITHUB\CppLeetNinjas\0404左叶子之和\404.左叶子之和递归.cpp", "C++", 21, 0, 8, 5, 34
"f:\GITHUB\CppLeetNinjas\0429N叉树的层序遍历\429.n-叉树的层序遍历.cpp", "C++", 39, 0, 8, 8, 55
"f:\GITHUB\CppLeetNinjas\0444序列重建\444.序列重建.cpp", "C++", 43, 0, 1, 8, 52
"f:\GITHUB\CppLeetNinjas\0450删除二叉搜索树中的节点\450.删除二叉搜索树中的节点.cpp", "C++", 47, 0, 10, 8, 65
"f:\GITHUB\CppLeetNinjas\0450删除二叉搜索树中的节点\README.markdown", "Markdown", 0, 23, 0, 6, 29
"f:\GITHUB\CppLeetNinjas\0454四数相加 II\4sum-ii.cpp", "C++", 28, 0, 3, 2, 33
"f:\GITHUB\CppLeetNinjas\0459重复的子串\459.重复的子字符串.cpp", "C++", 5, 0, 7, 2, 14
"f:\GITHUB\CppLeetNinjas\0491递增子序列\46.全排列.cpp", "C++", 24, 0, 7, 4, 35
"f:\GITHUB\CppLeetNinjas\0491递增子序列\491.递增子序列.cpp", "C++", 29, 0, 7, 6, 42
"f:\GITHUB\CppLeetNinjas\0491递增子序列\REDAME.md", "Markdown", 0, 25, 0, 21, 46
"f:\GITHUB\CppLeetNinjas\0501二叉搜索树中的众数\501.二叉搜索树中的众数.cpp", "C++", 44, 0, 11, 8, 63
"f:\GITHUB\CppLeetNinjas\0513找树左下角的值\513.找树左下角的值迭代法.cpp", "C++", 33, 0, 8, 4, 45
"f:\GITHUB\CppLeetNinjas\0513找树左下角的值\513.找树左下角的值递归法.cpp", "C++", 20, 0, 17, 6, 43
"f:\GITHUB\CppLeetNinjas\0513找树左下角的值\README.markdown", "Markdown", 0, 35, 0, 13, 48
"f:\GITHUB\CppLeetNinjas\0515在每个树行中找最大值\515.在每个树行中找最大值.cpp", "C++", 22, 0, 20, 5, 47
"f:\GITHUB\CppLeetNinjas\0530二叉搜索树的最小绝对差\530.二叉搜索树的最小绝对差.cpp", "C++", 32, 0, 10, 6, 48
"f:\GITHUB\CppLeetNinjas\0530二叉搜索树的最小绝对差\530.二叉搜索树的最小绝对差递归.cpp", "C++", 21, 0, 17, 9, 47
"f:\GITHUB\CppLeetNinjas\0538把二叉搜索树转换为累加树\538.把二叉搜索树转换为累加树.cpp", "C++", 24, 0, 8, 6, 38
"f:\GITHUB\CppLeetNinjas\0541反转字符串 II\README.markdown", "Markdown", 0, 17, 0, 8, 25
"f:\GITHUB\CppLeetNinjas\0541反转字符串 II\reverse-string-ii.cpp", "C++", 25, 0, 0, 5, 30
"f:\GITHUB\CppLeetNinjas\0617合并二叉树\617.合并二叉树.cpp", "C++", 35, 0, 8, 7, 50
"f:\GITHUB\CppLeetNinjas\0617合并二叉树\617.合并二叉树简化方法.cpp", "C++", 20, 0, 8, 7, 35
"f:\GITHUB\CppLeetNinjas\0637二叉树的层平均值\637.二叉树的层平均值.cpp", "C++", 33, 0, 8, 4, 45
"f:\GITHUB\CppLeetNinjas\0654最大二叉树\654.最大二叉树迭代法.cpp", "C++", 34, 0, 8, 2, 44
"f:\GITHUB\CppLeetNinjas\0654最大二叉树\654.最大二叉树递归法.cpp", "C++", 35, 0, 8, 4, 47
"f:\GITHUB\CppLeetNinjas\0654最大二叉树\README.markdown", "Markdown", 0, 34, 0, 14, 48
"f:\GITHUB\CppLeetNinjas\0669修剪二叉搜索树\669.修剪二叉搜索树.cpp", "C++", 24, 0, 8, 6, 38
"f:\GITHUB\CppLeetNinjas\0669修剪二叉搜索树\README.markdown", "Markdown", 0, 20, 0, 4, 24
"f:\GITHUB\CppLeetNinjas\0700二叉搜索树中的搜索\700.二叉搜索树中的搜索.cpp", "C++", 22, 0, 8, 4, 34
"f:\GITHUB\CppLeetNinjas\0701二叉搜索树中的插入操作\701.二叉搜索树中的插入操作.cpp", "C++", 25, 0, 8, 5, 38
"f:\GITHUB\CppLeetNinjas\0704二分查找\binary_search.cpp", "C++", 55, 0, 1, 5, 61
"f:\GITHUB\CppLeetNinjas\0707设计链表\0707design-linked-list.cpp", "C++", 87, 0, 0, 9, 96
"f:\GITHUB\CppLeetNinjas\0765情侣牵手\765.情侣牵手.cpp", "C++", 36, 0, 0, 9, 45
"f:\GITHUB\CppLeetNinjas\0977有序数组的平方\square_of_a_sorted_array.cpp", "C++", 29, 0, 0, 2, 31
"f:\GITHUB\CppLeetNinjas\1047删除字符串中的所有相邻重复项\1047.删除字符串中的所有相邻重复项_01.cpp", "C++", 21, 0, 7, 2, 30
"f:\GITHUB\CppLeetNinjas\1047删除字符串中的所有相邻重复项\1047.删除字符串中的所有相邻重复项_02.cpp", "C++", 16, 0, 7, 2, 25
"f:\GITHUB\CppLeetNinjas\1993树上的操作\1993.树上的操作.cpp", "C++", 57, 0, 17, 12, 86
"f:\GITHUB\CppLeetNinjas\2300咒语和药水的成功对数\2300. 咒语和药水的成功对数.cpp", "C++", 25, 0, 0, 4, 29
"f:\GITHUB\CppLeetNinjas\2568统计范围内的元音字符串数\2568.统计范围内的元音字符串数.cpp", "C++", 18, 0, 0, 1, 19
"f:\GITHUB\CppLeetNinjas\剑指Offer\0005替换空格\README.markdown", "Markdown", 0, 26, 0, 8, 34
"f:\GITHUB\CppLeetNinjas\剑指Offer\0005替换空格\ti-huan-kong-ge-lcof_01.cpp", "C++", 16, 0, 0, 1, 17
"f:\GITHUB\CppLeetNinjas\剑指Offer\0005替换空格\ti-huan-kong-ge-lcof_02.cpp", "C++", 27, 0, 0, 2, 29
"f:\GITHUB\CppLeetNinjas\剑指Offer\0058左旋转字符串\zuo-xuan-zhuan-zi-fu-chuan-lcof.cpp", "C++", 19, 0, 0, 3, 22
"f:\GITHUB\CppLeetNinjas\面试题\0207链表相交\README.markdown", "Markdown", 0, 18, 0, 2, 20
"f:\GITHUB\CppLeetNinjas\面试题\0207链表相交\intersection-of-two-linked-lists-lcci.cpp", "C++", 17, 0, 0, 1, 18
"Total", "-", 5162, 685, 844, 1136, 7827